                            SO                                          execute/2.xpm
                     WE execute/3.xpm
                    EA                              execute/4.xpm
                    NO                          execute/1.xpm

F 7,99, 99
C 200,4,4

111111111111111111111111111111111
100000000011000000000000000000001
101100000111000000000000000000001
100100000000000000000000000000001
111111111011000001110000000000001 
100000000011000001110111000001111
111101111111110111000000100000001
11111111111111111111111111111111
111111111111111111111111111111111
111101111111110111010100100000001
110000001101010111000000100000001
100000000000000011000000100000001
100000001000000011010100000000001
11000001 110101011111011110N000011
111101111111010111111110100000001
111111111111111111111111111111111