                            SO                                          /2.xpm
                     WE /3.xpm
                    EA                              /4.xpm
                    NO                          /1.xpm

F 7,99, 99
C 200,4,4

111111111111111111111111111111111
100000000011000000000000000000001
101100000111000000000000000000001
100100000000000000000000000000001
111111111011000001110000000000001 
100000000011000001110111000001111
111101111111110111000000100000001
1111111111111111111111111111111
111111111111111111111111111111111
11110111111111011101010010000000
110000001101010111000000100000001
100000000000000011000000100000001
100000001000000011010100000000001
11000001 110101011111011110N000011
111101111111010111111110100000001
111111111111111111111111111111111