 F   0, 128, 0
WE execute/3.xpm
NO execute/1  .xpm


 C    200 , 200 , 200
EA execute/4.xpm


11111
10001
10S01
10001
11111